█████████████████████████████████████
█                   █          $$$$$█
D                   X          $$$$$█
█                   █          $$$$$█
█████████████████████████████████████